NO ./texture_XPM/brick.xpm
WE ./texture_XPM/eagle.xpm
EA ./texture_XPM/blueWall.xpm
SO ./texture_XPM/eagle.xpm


F 204, 204, 153
C 153, 153, 102

11111111111111111111111111111111
10000000000000000000000000000001
10111111111111111100000111111111
1000000000000000000110000S000001
11111111111111000001101111111111
10000000000001000000001000000001
10110000000001011111101011111111
10000000000001010000001010000001
10111111111111011111111011111111
10000000000000000000000000000001
11111111111111111111111111111111
