NO ./texture_XPM/brick.xpm
WE ./texture_XPM/eagle.xpm
EA ./texture_XPM/blueWall.xpm
SO ./texture_XPM/eagle.xpm


F 204, 204, 153
C 153, 153, 102


        111111111111111111111111111111
        100000000011000000000000000001
        101100000111000000000000000001
        100100000000000000000000000001
11111111101100000111000000000000000001
10000000001100N00111011111111111111111
11110111111111011100000010001
11110111111111011101010010001
11111111111111111111111111111
                  
11111111111111111111111111111
11000000110101011100000010001
10000000000000001100000010001
10000000000000001101010010001
1100000111010101111101111000111
11110111 1110101 101111010001
11111111 1111111 111111111111