NO ./texture_XPM/north.xpm
WE ./texture_XPM/west.xpm
EA ./texture_XPM/east.xpm
SO ./texture_XPM/south.xpm


F 93, 93, 93
C  0, 96, 253

11111111111111111111111111111111
10000000000000000000000000000001
10000000000000000000000000000001
10000000000000000000000000000001
10000000000000000000000000000001
10000000000000000000000000000001
10000000000000000000000000000001
10000000000000000000000000000001
10000000000000000000000000000001
100000000000000N0000000000000001
10000000000000000000000000000001
10000000000000000000000000000001
10000000000000000000000000000001
10000000000000000000000000000001
10000000000000000000000000000001
11111111111111111111111111111111
