NO ./texture_XPM/brick.xpm
WE ./texture_XPM/eagle.xpm
EA ./texture_XPM/blueWall.xpm
SO ./texture_XPM/eagle.xpm


F 90, 60, 50
C 0, 96, 253

         111111111111111111111111
         100000000011000000000001
         101100000111000000000001
         100100000000000000000001
111111111111000001110000000000001
100000000011000001110111111111111
11110000000000011100000010001
11110000000000011101010010001
11000000110101000000000010001
10000000000000001100000010001
10000E00000000001101010010001
11000001110101011111011110001
11110111 1110101 101111010001
11111111 1111111 111111111111
