NO ./texture_XPM/brick.xpm
WE ./texture_XPM/eagle.xpm
EA ./texture_XPM/blueWall.xpm
SO    ./texture_XPM/eagle.xpm


F 220,100,0
C 225,30,0


        111111111111111111111111111111
        100000000011000000000000000001
        101100000111000000000000000001
        100100000000000000000000000001
11111111101100000111000000000000000001
10000000001100000111011111110111111111
11110111111111011100000010001
11110111111111011101010010001
11000000110101011100000010001
10000000000000001100000010001
10000000000000001101010010001
11000001010101011111011110N01
11110111 1110101 101111010001
11111111 1111111 111111111111
